SSSSSSSSSSSSSSSSSSSSSSSSSSSS
S.........................SS
XTTTTT....................SS
S....T....................SS
S....T....................SS
S....TTTTTTTTTTTT.........SS
S...............T.........SS
S...............TTTTTTTTTTTTE
S.........................SS
S.........................SS
SSSSSSSSSSSSSSSSSSSSSSSSSSSS
SSSSSSSSSSSSSSSSSSSSSSSSSSSS
SSSSSSSSSSSSSSSSSSSSSSSSSSSS
SSSSSSSSSSSSSSSSSSSSSSSSSSSS
SSSSSSSSSSSSSSSSSSSSSSSSSSSS



